


NO ./path_to_the_north_texture
SO ./path_to_the_south_texture

EA ./path_to_the_east_texture
1
WE ./path_to_the_west_texture

F 220,0,5


       111111111111110110
1111111100011000000000001
1011000001110000000000001
100100000000000000000000111111111
111111111011000001110000000000001
100000000011000001110111111111111
11110111111111011100000010001
111101111111110111010100100001
11000000110101011100000010001
10000000000011001100000010001
1000000000010 1110101001000N
11000001010101011111011110N0111
11110111011101011101111010001
11111111111111111101111111111


// Changement de conition de debut demap avec un compteur ?
// Utilisation exit(EXIT_FAILURE)
