

NO ./path_to_the_north_texture

SO ./path_to_the_south_texture
WE ./path_to_the_west_texture

EA ./path_to_the_east_texture

F 220,100,0

C 225,30,0



          1111111111111111111111
          1000000001111111111111
          1011000001100000000111
          1001000000000000001111
1111111111101100001100000000011
100000100001100001110011100001
111011100011110110W00010010001
100000000000000100000100000001111111
10000111110000010111110011111
100000000000011011101011
1000000000011100011111111111
1100111111111110101 1111010111
1111111 11111111111     111111111
1111 1111111




