NO ./texture/NO.xpm
SO ./texture/SO.xpm
WE ./texture/WE.xpm
EA ./texture/WE.xpm

F 89,85,68
C 176,173,160

1111111111111111111111111111111
1000000000000000000000000000001
1011000001100000000000000000001
1000000000000000000000000000001
1111111111101100001000000N00001
10000010000110000010000000001111111111
1110111000111101101000100000001111111111
1000000000000001000001000000011
100001111100000100000000000000111111
1110111010000000111111111111111
1111111111111111111111111
11111111111111111111111111111
10000000000001000111110000001
100000010000010101   10000011
100010000000000000111100000011
1111 111111111111111111111111111
