NO ./texture/small_chevre.xpm
SO ./texture/SO.xpm
WE ./texture/WE.xpm
EA ./texture/EA.xpm

F 126,80,15
C 28,184,234

1111111111111111111111111111111
10000000000000000000000000000001
10110000011000000000000000000001
10000000000000000000000000000001
11111111111011000000000000000011
100000100001100001110000000001
1110111000111101100000100000001
100000000000000100000100000001111111
10000111110000010000000000000011111
1000000000000110111010000N0011
10000000000001000111110000001
100000010000010101   10000011
100010000000000000111100000011
1111 111111111111111111111111111
