NO ./path_the_north_texture
SO ./path_the_south_texture
WE ./path_the_west_texture
EA ./path_the_east_texture

F 220,100,0
C 225,30,0

1111111111111111111111111111111
10000000000000000000000000000001
10110000011000000001110000000001
10000000000000000000000000000001
1111111111101100001100000000011
100000100001100001110011100001
111011100011110110S00010010001
100000000000000100000100000001111111
10000111110000010000000000000011111
100000000000011011101000000011
10000000000001000111110000001
100000010000010101   10000011
100010000000000000111100000011
1111 111111111111111111111111111
